20 20
100 100
6 6 6 6 6 6 6 6 6 6 6 6 6 6 6 6 6 6 6 6
6 0 0 0 0 0 0 0 0 0 0 0 0 0 0 0 0 0 0 6
6 0 0 0 0 0 0 0 0 0 0 0 1 1 1 1 1 0 0 6
6 0 0 0 0 0 0 0 0 0 0 0 1 1 1 1 1 0 0 6
6 0 0 0 0 0 0 0 0 0 0 0 1 1 1 1 1 0 0 6
6 0 0 0 0 0 0 0 0 0 0 0 0 0 0 0 0 0 0 6
6 0 0 0 0 0 0 0 0 0 0 0 0 0 0 0 0 0 0 6
6 0 0 0 0 0 0 0 0 0 0 0 0 0 0 0 0 0 0 6
6 0 0 0 0 0 0 0 0 1 1 1 0 0 0 0 0 0 0 6
6 0 0 0 0 0 0 0 0 1 1 1 0 0 0 0 0 0 0 6
6 0 0 0 0 0 0 0 0 1 1 1 0 0 0 0 0 3 0 6
6 0 0 0 0 0 0 0 0 0 0 0 0 0 0 3 0 0 0 6
6 0 0 0 0 0 0 0 0 0 0 0 0 0 0 0 0 0 0 6
6 0 0 0 0 0 3 0 0 0 3 3 3 3 3 3 3 3 3 6
6 0 0 0 0 0 0 0 3 0 3 3 3 3 3 3 3 3 3 6
6 0 0 0 0 0 3 0 0 3 3 3 3 3 3 3 3 3 3 6
6 0 0 0 0 0 0 0 3 3 3 3 3 3 3 3 3 3 3 6
6 0 0 0 0 0 3 0 3 0 3 3 3 3 3 3 3 3 3 6
6 0 0 0 0 0 0 0 3 3 3 3 3 3 0 3 3 3 3 6
6 6 6 6 6 6 6 6 6 6 6 6 6 6 6 6 6 6 6 6
